accent color = Akzentfarbe
accessibility = Zugänglichkeit
account = Konto
accessibility = Zugänglichkeit
actions = Aktionen
ad hoc = ad hoc
algorithm = Algorithmus
alignment = Ausrichtung
amplitude = Amplitude
anchor = Anker
angle = Winkel
anti-aliasing = Kantenglättung
arrangement = Anordnung
arrow = Pfeil
aspect ratio = Seitenverhältnis
avatar = Avatar
background = Hintergrund
billing = Abrechnung
bitmap = Bitmap
blend mode = Mischmodus
boolean operations = boolesche Operationen
break nodes = Knoten unterbrechen
brightness = Helligkeit
canvas = Leinwand
canvas space = Koordinatenraum der Leinwand
center horizontally = Horizontal zentrieren
center vertically = Vertikal zentrieren
circle = Kreis
color matrix = Farbmatrix
color scheme = Farbschema
component transfer = Komponenten-Übertragung
compositing = Komposition
cone angle = Kegelwinkel
connector = Verbinder
contrast = Kontrast
convolve matrix = Faltungsmatrix
corner radius = Eckenradius
custom filters = Benutzerdefinierte Filter
defs = Definitionen
diffuse lighting = Diffuse Beleuchtung
displacement map = Versatzkarte
distribution = Verteilung
distribution distance = Verteilungsdistanz
dithering = Dithering
drawing mode = Zeichenmodus
drop shadow = Schlagschatten
duplicate = Duplizieren
edge mode = Kantenmodus
ellipse = Ellipse
file size = Dateigröße
fill = Füllung
fill color = Füllfarbe
fill opacity = Deckkraft der Füllung
filter primitive = Filterbaustein
font = Schrift
font family = Schriftfamilie
font size = Schriftgröße
font style = Schriftstil
gamma correction = Gammakorrektur
garbage collector = Müllsammler
gaussian blur = Gaußscher Weichzeichner
grid = Gitternetz
gradient spread = Gradientenüberlauf
guides = Hilfslinien
hue = Farbton
hue rotation = Farbtondrehung
inner-radius = Innenradius
inner shadow = Schatten nach innen
jitter = Zufallswert
join nodes = Knoten verbinden
letter spacing = Buchstabenabstand
library = Bibliothek
light source = Lichtquelle
line = Linie
line cap = Linienendung
line join = Linienzusammentreffen
line spacing = Zeilenabstand
log in = Anmelden
log out = Abmelden
luminosity = Leuchtkraft
manual guides = manuellen Hilfslinien
motion blur = Bewegungsunschärfe
offset = Versatz
opacity = Deckkraft
orientation = Ausrichtung
path = Pfad
pattern = Muster
pixelete = Verpixeln
polygon = Polygon
polyline = Polylinie
posterize = Tontrennung
planar = Planar
polar = Polar
preferences = Einstellungen
preserve aspect ratio = Seitenverhältnis beibehalten
printing marks = Druckmarken
roundness = Rundheit
saturation = Sättigung
select all = Alles auswählen
smart guides = intelligenten Hilfslinien
smoothing = Glättung
source graphic = Quellgrafik
source alpha = Alphakanal der Quelle
source exponent = Quellexponent
specular lighting = Punktlicht
spiral = Spirale
stroke = Kontur
stroke opacity = Deckkraft der Kontur
stroke width = Breite der Kontur
transparency = Transparenz
transparent = transparent
turbulence = Turbulenz
vectorize = vektorisieren
vectors = Vektoren
