actions = acciones
account = cuenta
alpha = alfa
amount = cantidad
amplitude = amplitud
angle = ángulo
animation = animación
antialiasing = suavisado de bordes
apply = aplicar
arrange = organizar
arrow = flecha
aspect ratio = relación de aspecto
azimuth = acimut
bleed = sangrado
blend mode = modo de mezcla
blur = desenfoque
boolean operation = operación booleana
bounding box = caja de contorno
brightness = brillo
bug = error
canvas = lienzo
channel = canal
clipping mask = máscara de recorte
close = cerrar
color burn = subexponer
color dodge = sobreexponer
color replacement = sustitución de color
colorize = colorizar
component transfer = transferencia de componentes
complexity = complejidad
contrast = contraste
convert text to paths = convertir textos en trayectos
copy = copiar
corner = esquina
corner radius = radio de esquina
crop = recortar
cut = cortar
darken = oscurecer
delete = eliminar
depth = profundidad
description = descripción
deselect = deseleccionar
diffuse Light = luz difusa
dilatation = dilatación
disable = desactivar
discrete = discreto
distant light = luz distante
drawing mode = modo de dibujo
drop shadow = sombra paralela
duotone = duotono
duplicate = duplicar
elevation = elevación
ellipse = elipse
enable = activar
erosion = erosión
exclusion = exclusión
export = exportar
exposure = exposición
file = archivo
fill = rellenar
the fill = relleno
fill color = color de relleno
fill opacity = opacidad de relleno
filter = filtro
filters = filtros
flip = voltear
folder = carpeta
foreground = primer plano
fractal noise = ruido fractal
gamma = gamma
gamma correction = corrección de gamma
glow = brillo
glyphs = glifos
gradient = degradado
gradient spread = extender de degradado
gradient stop = parada de degradado
greyscale = escala de grises
grid = rejilla
guide = guía
guides = guías
hard light = luz fuerte
hardness = dureza
horizontal blur = desenfoque horizontal
horizontal spacing = espaciado horizontal
height = alto
history = historial
hue = tono
hue rotate = rotar tono
hue rotation = rotación de tono
ID = ID
image = imagen
image size = tamaño de la imagen
inner shadow = sombra interior
install = instalar
interpolate = interpolar
interpolation = interpolación
invert = invertir
invert colors = invertir colores
jitter = fluctuación
keyboard shortcuts = atajos de teclado
language = idioma
lasso = lazo
layer = capa
lighten = aclarar
lighting color = color de iluminación
lightness = luminosidad
line = línea
linear gradient = degradado lineal
log in = acceder
log out = cerrar sesión
luminosity = luminosidad
marker = marcador
mask = máscara
miter = inglete
miter limit = límite de inglete
monochromatic = monocromático
noise = ruido
noise reduction = reducción de ruido
normalize = normalizar
number of steps = número de pasos
object = objeto
offset = desvío
outline = contorno
opacity = opacidad
open = abrir
options = opciones
paragraph = párrafo
paste = pegar
path = trayecto
pattern = patrón
perspective = perspectiva
point light = luz puntual
polygon = polígono
polyline = polilínea
posterize = posterizar
preferences = preferencias
print = imprimir
quality = calidad
radial gradient = degradado radial
radius = radio
raise = elevar
raised = elevado
rasterize = rasterizar
rectangle = rectángulo
redo = rehacer
rendering Mode = modo de renderizado
replace color = reemplazar color
reset = restablecer
rotate = girar
roundness = redondez
ruler = regla
saturate = saturar
saturation = saturación
save = guardar
scale = escalar
selection = selección
shape = forma
share = compartir
sharpen = agudizar
sigma = sigma
simplify = simplificar
skew = inclinar
smoothness = suavidad
spacing = espaciado
specular light = luz especular
spiral = espiral
spot light = luz de foco
square = cuadrado
star = estrella
stroke = trazo
stroke color = color del trazo
stroke opacity = opacidad de trazo
style = estilo
symbol = símbolo
text anchor = ancla de texto
text baseline = línea base de texto
theme = tema
threshold = umbral
transparency = transparencia
transparent = transparente
turbulence = turbulencia
undo = deshacer
unsharp mask = máscara de enfoque
width = ancho
window = ventana
variation = variación
vectorize = vectorizar
vertical blur = desenfoque vertical
vertical spacing = espaciado vertical
view = vista
# Could be translated to "vista de contenido" or "caja de vista", but we use the English term as it is more widely known
view box = view box
viewbox = viewbox
# Could be translated to "vista de lienzo" or "ventana de vista", but we use the English term as it is more widely known
viewport = viewport
zoom in = acercar
zoom out = alejar
