3-point = 3-punktowy
accent color = kolor akcentu
ad hoc = ad hoc
blend mode = tryb mieszania
bug = błąd
canvas = kanwa
cloud storage = przechowywanie w chmurze
cog = trybik
color matrix = macierz kolorów
compositing = kompozycja
connector = połączenie
corner radius = zaokrąglenie narożników
cross = krzyżyk
custom = własny
def = definicja
defs = definicje
diffuse lighting = światło rozproszone
drop shadow = cień padający
fill = wypełnienie
filter primitive = składowa filtra
fixed in version = naprawiono w wersji
freehand tool = narzędzie Rysowanie
from defs = z definicji
garbage collector = śmieciarka
gaussian blur = rozmycie gaussowskie
gradient stop = punkt gradientu
inner shadow = cień wewnętrzny
marker = marker
matrix = macierz
menubar = pasek menu
node = węzeł
nodes = węzły
noise = szum
pattern = deseń
pie = tort
pinned = przypięte
planar = planarny
polar = polarny
preset filter = predefiniowany filtr
pressure = nacisk
primitive = składowa
radial gradient = gradient kołowy
specular lighting = światło plamiste
spline = splajn
symbol instance = instancja symbolu
stroke = kontur
SVG file = plik SVG
test case = przykład
text anchor = zakotwiczenie tekstu
theme = motyw
transform origin = punkt początkowy transformacji
transparent = przezroczysty
ungroup = odgrupuj
unhide = odkryj
unpinned = nieprzypięte
upstream = na wyższym szczeblu
viewport = viewport
view box = view box
viewbox = viewbox
