actions = ações
account = conta
alpha = alfa
amount = quantidade
amplitude = amplitude
angle = ângulo
animation = animação
antialiasing = suavização de bordas
apply = aplicar
arrange = organizar
arrow = seta
aspect ratio = proporção de aspecto
azimuth = azimute
bleed = sangria
blend mode = modo de mesclagem
blur = desfoque
boolean operation = operação booleana
bounding box = caixa delimitadora
brightness = brilho
bug = erro
canvas = tela
channel = canal
clipping mask = máscara de recorte
close = fechar
color burn = queimar cor
color dodge = desviar cor
color replacement = substituição de cor
colorize = colorizar
component transfer = transferência de componente
complexity = complexidade
contrast = contraste
convert text to paths = converter texto em trajetos
copy = copiar
corner = canto
corner radius = raio de canto
crop = cortar
cut = cortar
darken = escurecer
delete = excluir
depth = profundidade
description = descrição
deselect = desselecionar
diffuse Light = luz difusa
dilatation = dilatação
disable = desativar
discrete = discreto
distant light = luz distante
drawing mode = modo de desenho
drop shadow = sombra projetada
duotone = duotomia
duplicate = duplicar
elevation = elevação
ellipse = elipse
enable = habilitar
erosion = erosão
exclusion = exclusão
export = exportar
exposure = exposição
file = arquivo
fill = preencher
the fill = preenchimento
fill color = cor de preenchimento
fill opacity = opacidade de preenchimento
filter = filtro
filters = filtros
flip = virar
folder = pasta
foreground = primeiro plano
fractal noise = ruído fractal
gamma = gama
gamma correction = correção de gama
glow = brilho
glyphs = glifos
gradient = gradiente
gradient spread = propagação de gradiente
gradient stop = parada de gradiente
greyscale = escala de cinza
grid = grade
guide = guia
guides = guias
hard light = luz intensa
hardness = dureza
horizontal blur = desfoque horizontal
horizontal spacing = espaçamento horizontal
height = altura
history = histórico
hue = matiz
hue rotate = rotação de matiz
hue rotation = rotação de matiz
ID = ID
image = imagem
image size = tamanho da imagem
inner shadow = sombra interna
install = instalar
interpolate = interpolar
interpolation = interpolação
invert = inverter
invert colors = inverter cores
jitter = oscilação
keyboard shortcuts = atalhos de teclado
language = idioma
lasso = laço
layer = camada
lighten = clarear
lighting color = cor de iluminação
lightness = luminosidade
line = linha
linear gradient = gradiente linear
log in = entrar
log out = sair
luminosity = luminosidade
marker = marcador
mask = máscara
miter = chanfro
miter limit = limite de chanfro
monochromatic = monocromático
noise = ruído
noise reduction = redução de ruído
normalize = normalizar
number of steps = número de passos
object = objeto
offset = deslocamento
outline = contorno
opacity = opacidade
open = abrir
options = opções
paragraph = parágrafo
paste = colar
path = caminho
pattern = padrão
perspective = perspectiva
point light = luz pontual
polygon = polígono
polyline = polilinha
posterize = posterizar
preferences = preferências
print = imprimir
quality = qualidade
radial gradient = gradiente radial
radius = raio
raise = elevar
raised = elevado
rasterize = rasterizar
rectangle = retângulo
redo = refazer
rendering Mode = modo de renderização
replace color = substituir cor
reset = redefinir
rotate = girar
roundness = arredondamento
ruler = régua
saturate = saturar
saturation = saturação
save = salvar
scale = escala
selection = seleção
shape = forma
share = compartilhar
sharpen = afiar
sigma = sigma
simplify = simplificar
skew = inclinar
smoothness = suavidade
spacing = espaçamento
specular light = luz especular
spiral = espiral
spot light = luz de ponto
square = quadrado
star = estrela
stroke = traço
stroke color = cor do traço
stroke opacity = opacidade do traço
style = estilo
symbol = símbolo
text anchor = ancoragem de texto
text baseline = linha de base do texto
theme = tema
threshold = limiar
transparency = transparência
transparent = transparente
turbulence = turbulência
undo = desfazer
unsharp mask = máscara de nitidez
width = largura
window = janela
variation = variação
vectorize = vetorizar
vertical blur = desfoque vertical
vertical spacing = espaçamento vertical
view = visualização
view box = caixa de visualização
viewbox = viewbox
viewport = viewport
zoom in = aumentar zoom
zoom out = diminuir zoom
